so	SO
sore	SOR
stove	STOF
store	STOR
scoff	SKOF
discover	SKOFR
score	SKOR
to	TO
tour	TOR
tore	TO*R
do	TKO
dove	TKOF
could	KO
cough	KOF
cover	KOFR
coffer	KO*FR
core	KOR
to	O
off	OF
offer	OFR
or	OR